################
#              #
#              #
#              #
#   ####       #
#            ###
#              #
#              #
#              #
#          #####
#              #
#              #
#    #####     #
#              #
#              #
################