################
#              #
#       ####   #
#              #
#              #
###            #
#              #
#              #
#              #
#          #####
#              #
#              #
#    #####     #
#              #
#              #
################