################
#              #
#              #
#      ####    #
#              #
#              #
#    ##        #
#              #
#              #
#          #####
#              #
#              #
#    #####     #
#              #
#              #
################