################
#              #
#              #
#              #
#              #
#       ####   #
#              #
#              #
#              #
#              #
#   ####       #
#            ###
#              #
#              #
#              #
#          @@@@#
#              #
#              #
#    #####     #
#              #
#              #
################