################
#              #
#              #
#@@@@@@   @@@@@#
#              #
#       ####   #
#              #
#@@@@@@        #
#              #
#              #
#   ####       #
#            ###
#              #
#@@@@@@@@@@    #
#              #
#    @@@@@@@@@@#
#              #
#  P            #
#    #####     #
#@@ @@@@@@@@@  #
#              #
#@@@@@@@@@@@@@@#