#######################
#                     #
#                     #
#   ####              #
#                   ###
#                     #
#        ####         #
#                     #
#                 #####
#                     #
#    #####            #
#              P      #
#             @@@@    #
#######################